NO /texture/north.xpm
SO /texture/south.xpm
WE /texture/west.xpm 
EA /texture/east.xpm

F 220,100,0
C 225,30,0

11111111111111111111
10000000000100000011
10000000000011100001
10010000000000000101
10000000000000000001
10000000000000000001
100000N0000001001001
11111111111111111111