
F 220,100,0
C 225,30,0

NO /texture/north.xpm
SO /texture/south.xpm
WE /texture/west.xpm 
EA /texture/east.xpm

1111111111111111111
1000000000010000001
10000000001110000111111111111111111111111111111111111111111111111111
1                1                1
1              1                 111
11111111111111111111111111111111111
11111111111111111111                    
100100000000000001011111
10000000000000000010001
10000111111111111111111
100000N0000001001001
11111111111111111111