NO ./textures/north.xpm
SO ./textures/south.xpm
WE ./textures/west.xpm
EA ./textures/east.xpm

F 1,1,1
C 1,1,1

111111111111111111111
1010000000000000W0001
101010101011111111111
101010101011111110001
101110101010101010101
100000100010001010001
111111101111111011101
100000101000100010001
101110101110101110111
101000100000100010101
101011111011111010101
100010000000000010001
101010111001111111101
101000001000000000001
111111110000011111111
111111111000111111111
111111111101111111111
111111111101111111111
111111111101111111111
111111111101111111111
111111111101111111111
111111111101111111111
111111111101111111111
111111111101111111111
111111111101111111111
111111111101111111111
111111111101111111111
111111111101111111111
111111111101111111111
111111111101111111111
100000000000000000001
100000000000000000001
100000000000000000001
100000000000000000001
100111111001111110001
100100000001000000001
100100000001000000001
100100111101001111001
100100000101000001001
100100000101000001001
100111111101111111001
100000000000000000001
100000000000000000001
100000000000000000001
100000000000000000001
111111111111111111111