NO ./textures/north.xpm
SO ./textures/south.xpm
WE ./textures/west.xpm
EA ./textures/east.xpm

F 230,169,184
C 135,206,235

11111111111
100W0000001 
100001000111
100001100001


100001000111
11111111111