F 230,169,184
C 135,206,235

NO textures/north.xpm
SO textures/south.xpm
WE textures/west.xpm 
EA textures/east.xpm

1111111111111111111
100000000010000001
10000000001110000111111111111111111111111111111111111111111111111111
1                1                1
1              1                111
111111111100001111111111111111111111
11111111100000111111                    
100100000000000001011111
10000000000000000010001
1000011111111111111111
100000W0000001001001
11111111111111111111