NO ./textures/north.xpm
SO ./textures/south.xpm
WE ./textures/west.xpm
EA ./textures/east.xpm

F 220,100,100
C 225,30,0

11111111111
100W0000001 
100001000111
100001100001


100001000111
11111111111