NO ./textures/north.xpm
SO ./textures/south.xpm
WE ./textures/west.xpm
EA ./textures/east.xpm

F 18,53,25
C 153,204,255

        1111111111111111111111111
        1000000000110000000000001
        1011000001110000000000001
        1001000000000000000000001
111111111011000001110000000000001
100000000011000001110111111111111
11110111111111011100000010001
11110111111111011101010010001111111111000000000000000000000000001
11000000110       101011100000010001
10000000000  N    000001100000010001
10000000000       000001101010010001
11000001110101011111011110011111111
11110111 1110101 101111010001
11111111 1111111 111111111111