NO /texture/north.xpm
SO /texture/south.xpm
WE /texture/west.xpm 
EA /texture/east.xpm

F 220,100,0
C 225,30,0

111111111111111111111
11000000N0000p00011011
11002000000000100001
10000000010000010011
11111111111111111111
