NO /texture/north.xpm
SO /texture/south.xpm
WE /texture/west.xpm 
EA /texture/east.xpm

ddqdwe
uiferfgfga

1111111
1N00011
1111111                  
1111111