NO /texture/north.xpm
SO /texture/south.xpm
WE /texture/west.xpm 
EA /texture/east.xpm

F 220,100,0
C 225,30,0

  1111111111111111111
1100000000000N00011
11000000000000100001111111111111111
10000000010000010010
11111111111111111110