NO /texture/north.xpm
SO /texture/south.xpm
WE /texture/west.xpm 
EA /texture/east.xpm

F 220,100,0
C 225,30,0

11111111111111111111
11000000000000000111
11000000000000100001
10000000010000010010
11111111111111111111